
R   3000   2000

NO srcs/textures/WALL_N.xpm
  SO   ./srcs/textures/WALL_S.xpm
WE ./srcs/textures/WALL_W.xpm

EA ./srcs/textures/kitty.xpm
S srcs/textures/sprite_1.xpm

F 220, 100,0
C    225,30,0

        1111111111111111111111111
        1000000000110000000000001
        1011000001110000000000001
        1001000000000000000000001
111111111011000001110000000000001
100000000011000001110111111111111

11110111111111011100000000001
11112111111111011101010000001
11020200110101011100000000001
10000200000000001100000000001
100000000N0000001100010000001
1100000111010101111100000000111
10110111 1110101 101111000001
11111111 1111111 111111111111
