
R   800   500

NO srcs/textures/WALL1.xpm
  SO   ./srcs/textures/WALL2.xpm
WE ./srcs/textures/WALL3.xpm

EA ./srcs/textures/WALL4.xpm
S srcs/textures/kitty.xpm

F 16, 143,98
C    206,235,242

        1111111111111111111111111
        1000000000110000000000001
        1011000001110000002000001
        1001000000000000000000001
111111111011000201110000000000001
100000000011000001110111111111111

11110111111111011100000000001
11112111111111011101010000001
11020200110101011100000000001
10000000000000001100000200001
100000000N0000001100010000001
1100000111010101111100000000111
10110111 1110101 101111000001
11111111 1111111 111111111111
