
R   1000    500

NO srcs/textures/cat.xpm
  SO   ./srcs/textures/WALL_S.xpm
WE ./srcs/textures/WALL_W.xpm

EA ./srcs/textures/WALL_E.xpm
S srcs/textures/cat.xpm

F 220, 100,0
C    225,30,0

        1111111111111111111111111
        1000000000110000000000001
        1011000001110000002000001
        1001000000000000000000001
111111111011000001110000000000001
100000000011000001110111111111111
11110111111111011100000000001
11112111111111011101010000001
11000000110101011100000000001111111111111111111111111111111111111111111111111111111111111111111111111111111111111111111111111111111111111111111111111111111111111111111111111111111111111111111111111111111111111111111111111111111111111111111111111111111111111111111111111111111111111111111111111
100000000000000011E0000000000000000000000000000000000000000000000000000000000000000000000000000000000000000000000000000000000000000000000000000000000000000000000000000000000000000000000000000000000000000000000000000000000000000000000000000000000000000000000000000000000000000000000000000000001
10000000000000001100010000001111111111111111111111111111111111111111111111111111111111111111111111111111111111111111111111111111111111111111111111111111111111111111111111111111111111111111111111111111111111111111111111111111111111111111111111111111111111111111111111111111111111111111111111111
1100000111010101111100000000111
10110111 1110101 101111000001
11111111 1111111 111111111111
