
R   2000 500

NO srcs/textures/WALL_N.xpm
  SO   ./srcs/textures/WALL_S.xpm
WE ./srcs/textures/WALL_W.xpm

EA ./srcs/textures/WALL_E.xpm
S srcs/textures/kitty.xpm

F 3, 133,98
C    220,255,250

111111111111111111111111111
122222222222222222222222221
122222222222222222222222221
120000000000000200000000021
120020200000000000000000021
120002120000000000000000021
120021112000000000200000021
120002120001010000000000021
122222222221N12222222222221
111111111111111111111111111
